index;nodeA;nodeB;cost;capa;type
1;1;4;1;1;1
2;1;5;1;1;1
3;2;4;1;1;1
4;2;5;1;1;1
5;3;4;1;1;1
6;3;5;1;1;1